1111111111111
10010C00000C1
10C0011100001
1P1011E0010C1
1111111111111
