1111111111111
10010C0000011
10C0011100001
100011E0010C1
1111111111111
