11111111111111111111111
10010C00000100000010001
10C00111000000000000001
1P0011E0010C00000000001
11111111111111111111111
