11111111111111111111
10010C00000100000001
10C0011100000000C001
1P0011E0010C01000001
11111111111111111111
