1111111111111111111111111111111111111111
1000000000000000C000000E0000000111001001
1P00010000000C01110000000000000000011101
1110C00000000010000000000111000000000001
1111110001000000001000000000111000000001
1111110000000000000000111000000100000001
111000000C00001000001C000000000C0001C001
1111111111111111111111111111111111111111
