1111111111
1P0100C0E1
1111111111