1111111111
100P0XC0E1
1111111111