1111111111111111111111111111111111111111
1C00000000000010000000111111111111111111
1000000000000000000C00111111111111111111
1101110000111100C00000111111111111111111
1E00000000111100000000111111111111111111
1111111100011100P00000111111111111111111
1000000000000100000000111111111111111111
10C0000000000100000000111111111111111111
1101110000111100000C00111111111111111111
10000000000C0000000000111111111111111111
1111111111111111111111111111111111111111
1111111111111111111111111111111111111111
1111111111111111111111111111111111111111
1111111111111111111111111111111111111111
1111111111111111111111111111111111111111
1111111111111111111111111111111111111111
1111111111111111111111111111111111111111
1111111111111111111111111111111111111111
1111111111111111111111111111111111111111
1111111111111111111111111111111111111111
1111111111111111111111111111111111111111
